15
10
.....X+.++.....
.&..........++O
++.++++++++..+.
.......+.+.....
++.............
..............+
..+++++++++++..
.+++...........
......++.+.+.++
++.............
