23
6
...++++++++++++++++++++
...++++++++++++++++++++
+..++++++++++++++++++++
O&.....................
+.++++++++++++++++++++.
+X.....................
