15
10
.....X+.+++...+
.&.&........++O
++.++++++++....
.......+.+...+.
++............O
.&.....O......+
..+++++++++++..
.+++...........
......++.+.+.++
++.............
